7
13
11
1100000000000
1110111111100
1010100000000
1000110010001
1111111111111
1000100100101
1000101111101
1111101011001
1000101001001
0000011111112



1311111111111
1100100000001
1011100011111
1000110010001
1111111111111
1000100100101
1000101111101
1111101011001
1000101001001
1211111111111



1111111113111
1000100000001
1000100011111
1000100010001
1111111111111
1000100000101
1000101111101
1000101001001
1000101001001
2111111111111



1131111111111
1111111111111
1111111111111
1111111111111
1111111111111
1111111111111
1111111111111
1111111111111
1111111111111
1211111111111



1111111111111
1111111111111
1111113111111
1111111111111
1111111111111
1111111111111
1111111111111
1111111111111
1111111111111
1121111111111



1111111111111
1111111111111
1111111111111
1111113111111
1111111111111
1111111111111
1111111111111
1111111111111
1111111111111
1112111111111



1111111111111
1111111111111
1111111111111
1111111111111
1111113111111
1111111111111
1111111111111
1111111111111
1111111111111
1111111111111
