1
19
11
1111121111111111111111111
1000100000001111111111111
1000100011111111111111111
1000100010001111111111111
1111111111111111111111111
1000100000101111111111111
1000101111101111111111111
1000101001001111111111111
1000101001001111111111111
1111111111111111111111111
